20 15
START 2 2
GOAL 17 12
0 0 0 0 0 0 0 0 0 0 0 0 0 0 0 0 0 0 0 0
0 0 0 1 1 1 1 0 0 0 0 0 1 1 1 0 0 0 0 0
0 0 0 0 0 0 1 0 1 1 1 0 1 0 0 0 0 1 1 0
0 1 1 1 0 0 0 0 0 0 1 0 0 0 0 1 1 1 0 0
0 0 0 1 0 1 1 1 0 0 0 0 0 0 0 1 0 0 0 0
0 0 0 0 0 0 0 1 1 1 0 0 1 1 0 0 0 0 1 0
0 1 1 0 0 0 0 0 0 0 0 0 1 0 0 0 0 0 1 0
0 0 1 0 1 1 1 0 0 0 0 0 0 0 1 1 1 0 0 0
0 0 0 0 0 0 1 0 1 1 1 1 0 0 1 0 0 0 0 0
0 0 0 0 0 0 0 0 0 0 0 1 0 0 0 0 1 1 1 0
0 1 1 1 0 0 0 0 0 0 0 0 0 0 0 0 0 0 1 0
0 0 0 1 1 1 0 0 0 0 0 0 0 1 1 0 0 0 0 0
0 0 0 0 0 0 0 1 1 0 0 0 0 1 0 0 0 0 0 0
0 0 0 0 0 0 0 0 0 0 0 0 0 0 0 0 0 0 0 0
0 0 0 0 0 0 0 0 0 0 0 0 0 0 0 0 0 0 0 0