10 8
START 1 1
GOAL 8 6
0 0 0 0 0 0 0 0 0 0
0 0 0 1 1 1 0 0 0 0
0 1 0 0 0 1 0 1 0 0
0 1 0 1 0 0 0 1 0 0
0 0 0 1 1 1 0 0 0 0
0 0 0 0 0 0 0 1 1 0
0 0 1 1 0 0 0 0 0 0
0 0 0 0 0 0 0 0 0 0